coordonnees du terrain : 22, 40
coordonnees sortie : 17, 39	
score a atteindre : 0
Temps imparti : 120

MMMMMMMMMMMMMMMMMMMMMMMMMMMMMMMMMMMMMMMM
MTTTTTT TTDTP TTTTTPTPTTTTTTT TTTTPTTTTM
MTPJPTTTTTT TTTTTTTTTPDTTPTTTT TTTTT TTM
MTTTTTTTTTT TT TTTTTPTPTTPTTTTTTTTPTTTTM
MPT  TTTTTTTTTPTTTTTTPTTPTTTTPTTTPTTTTTM
MPTPPTTTTTTTTTPPTTPTTTTTTTTPTTTTTTPTP TM
MTTTPTTPTTTTTTTTPTTTTTPT PTTTTTTTTPTPPTM
MMMMMMMMMMMMMMMMMMMMMMMMMMMMMMMTTTPTTPTM
MT TTTPTTDT TTPTPTTTTTTTTTTDTP TTTTTTPTM
MTTDTTTTTPTTTTT TTTTTTTTP  PTTDTTTTPTTTM
MTTTPTTPTPTTTTTTTTTTTTTTPPTPTTPTTTTTTTTM
MT TTTTTPTTTTTTTTPP TTTTTTTPTTPTDTTTT TM
MTPTT TTPT  TTTTTPTPDTTDTTTTPTTTPTTDTPTM
MTDPTTTTTTTTTTTTTTPPPTTPTTTTTTTTDTTTTTPM
MTTTTTTTTMMMMMMMMMMMMMMMMMMMMMMMMMMMMMMM
M  TTTTTTTTT TTTDTTTTPTTTTTPTTTPTTTTTTTM
MP TTTTTTTTTPPTTPTTTTTTTTPTTTTTTPTP TTMM
MTPTTPTTTTTTTTPTTTTTPT  TTTTDTTTPTPPTTTM
MTTTTPDTT TTTTTTTTPTTTTTTPTPDTTTTTTPTTTM
MTTT TT TPTTPTPPTTTTTTTTTPTPDTTTTTTPTTPM
MTDTTTTPTTTTT TTTTTTTTT TPTTPTTTTPTTTPTM
MMMMMMMMMMMMMMMMMMMMMMMMMMMMMMMMMMMMMMMM

########################################

coordonnees du terrain : 22, 40
coordonnees sortie : 21, 19
score a atteindre : 100
Temps imparti : 150

MMMMMMMMMMMMMMMMMMMMMMMMMMMMMMMMMMMMMMMM
MTPTTPTTMTPTTTDTMTTTPTPTM TTTTTTMTTPPTTM
MTTTTTTTMTTTTTT M  T TTTM TT TTTMTTTT TM
M              P PP      P  D        P M
MDTTTTTTMTPTTTTPMTPT TT MTTPTTDTMTTPTPTM
MTTTTTTTMTPTTTTPMTPT  TTMTTTTTPTMTTT TTM
MMMMMMMMMMMMMMMMMMMM MMMMMMMMMMMMMMMMMMM
MTTTTPPTMTTPTTTTMTTT TTPMTTTTPTTMTTTTTPM
MTTTTTTTMTT TTTTMTTT TTTMTTTTPTDMTTTTTPM
M                                      M
MPTTPTTTMTTTTPTTMTTP TTTMTTTTTT M TTTTTM
MPTTTTPTMTTPTTPTMTTT T  MTTTTTTTMPTTTPTM
MTPTTTTTMTTTPTTTMTTT TPPMTTTTTTTMPPTTPTM
MMMMMMMMMMMMMMMMMMMM MMMMMMMMMMMMMMMMMMM
MPT  ETTMTTTTPTPMTTT TTTMTPDTTPTMTTTTTTM
MTTTTTPTMPTTTTTTMTTD TTTM TTPTTTMTPTPPTM
M                                      M
MDTT TPTMPTTTTPTMTPT TTPMTPTPTTTMTTTTTTM
MTTTTTPTMPTTDTTTMTTT PTTMTTPTTTTMTTTPPPM
MTDTTT  MTTPTTTTMTJD  TTMT TTTTTMTTT   M
MTPTTTTPMTT TTPTMTMTPTTTMTTTTPTPMTTTTPTM
MMMMMMMMMMMMMMMMMMMMMMMMMMMMMMMMMMMMMMMM

########################################

